【タブ】	
：	\0


（バイト値,1）	
（バイト値,１）	
（バイト値、1）	
（バイト値、１）	
（バイト値，1）	
（バイト値，１）	
（バイト値､1）	
（バイト値､１）	
（バイト値1）	
（バイト値１）	
（b1）	
（ｂ１）	



（bg,	（call,bg,
（bg、	（call、bg、
（bg，	（call，bg，
（bg､	（call､bg､
（ｂｇ,	（call,bg,
（ｂｇ、	（call、bg、
（ｂｇ，	（call，bg，
（ｂｇ､	（call､bg､
（freeimage,	（call,freeimage,
（freeimage、	（call、freeimage、
（freeimage，	（call，freeimage，
（freeimage､	（call､freeimage､
（ｆｒｅｅｉｍａｇｅ,	（call,freeimage,
（ｆｒｅｅｉｍａｇｅ、	（call、freeimage、
（ｆｒｅｅｉｍａｇｅ，	（call，freeimage，
（ｆｒｅｅｉｍａｇｅ､	（call､freeimage､
（image,	（call,image,
（image、	（call、image、
（image，	（call，image，
（image､	（call､image､
（ｉｍａｇｅ,	（call,image,
（ｉｍａｇｅ、	（call、image、
（ｉｍａｇｅ，	（call，image，
（ｉｍａｇｅ､	（call､image､
（next,	（call,next,
（next、	（call、next、
（next，	（call，next，
（next､	（call､next､
（ｎｅｘｔ,	（call,next,
（ｎｅｘｔ、	（call、next、
（ｎｅｘｔ，	（call，next，
（ｎｅｘｔ､	（call､next､
（nextjump,	（call,nextjump,
（nextjump、	（call、nextjump、
（nextjump，	（call，nextjump，
（nextjump､	（call､nextjump､
（ｎｅｘｔｊｕｍｐ,	（call,nextjump,
（ｎｅｘｔｊｕｍｐ、	（call、nextjump、
（ｎｅｘｔｊｕｍｐ，	（call，nextjump，
（ｎｅｘｔｊｕｍｐ､	（call､nextjump､
（nextset,	（call,nextset,
（nextset、	（call、nextset、
（nextset，	（call，nextset，
（nextset､	（call､nextset､
（ｎｅｘｔｓｅｔ,	（call,nextset,
（ｎｅｘｔｓｅｔ、	（call、nextset、
（ｎｅｘｔｓｅｔ，	（call，nextset，
（ｎｅｘｔｓｅｔ､	（call､nextset､
（バックログ削除,	（call,バックログ削除,
（バックログ削除、	（call、バックログ削除、
（バックログ削除，	（call，バックログ削除，
（バックログ削除､	（call､バックログ削除､
（バックログ追加,	（call,バックログ追加,
（バックログ追加、	（call、バックログ追加、
（バックログ追加，	（call，バックログ追加，
（バックログ追加､	（call､バックログ追加､
（ボイス,	（call,ボイス,
（ボイス、	（call、ボイス、
（ボイス，	（call，ボイス，
（ボイス､	（call､ボイス､
（メニューボタン,	（call,メニューボタン,
（メニューボタン、	（call、メニューボタン、
（メニューボタン，	（call，メニューボタン，
（メニューボタン､	（call､メニューボタン､
（効果音,	（call,効果音,
（効果音、	（call、効果音、
（効果音，	（call，効果音，
（効果音､	（call､効果音､
（名札,	（call,名札,
（名札、	（call、名札、
（名札，	（call，名札，
（名札､	（call､名札､
（変数読み出し,	（call,変数読み出し,
（変数読み出し、	（call、変数読み出し、
（変数読み出し，	（call，変数読み出し，
（変数読み出し､	（call､変数読み出し､
（変数読み出しg,	（call,変数読み出しg,
（変数読み出しg、	（call、変数読み出しg、
（変数読み出しg，	（call，変数読み出しg，
（変数読み出しg､	（call､変数読み出しg､
（変数読み出しｇ,	（call,変数読み出しg,
（変数読み出しｇ、	（call、変数読み出しg、
（変数読み出しｇ，	（call，変数読み出しg，
（変数読み出しｇ､	（call､変数読み出しg､
（選択肢,	（call,選択肢,
（選択肢、	（call、選択肢、
（選択肢，	（call，選択肢，
（選択肢､	（call､選択肢､
（音ロード,	（call,音ロード,
（音ロード、	（call、音ロード、
（音ロード，	（call，音ロード，
（音ロード､	（call､音ロード､
（音停止,	（call,音停止,
（音停止、	（call、音停止、
（音停止，	（call，音停止，
（音停止､	（call､音停止､
（音楽,	（call,音楽,
（音楽、	（call、音楽、
（音楽，	（call，音楽，
（音楽､	（call､音楽､



（vncall,call,	（vncall,
（vncall，call，	（vncall，
（vncall､call､	（vncall､
（vncall、call、	（vncall、


