＊初期化
＃────────▼▼ここから里々の特殊変数▼▼────────	
＄NOTIFYの自動保存	有効
＄SAORI引数の計算	自動
＄なでられ時実行イベント	なでられ時の反応
＄トーク中のなでられ反応	有効
＄ユーザ名	ユーザ
＄会話時サーフェス戻し	無効
＄喋り間隔	１０秒
＄喋り間隔誤差	０％
＄自動挿入ウェイトの倍率	０％
＄自動挿入ウェイトタイプ	無効
＄自動改行挿入	無効
＄さくらスクリプトによるスコープ切り換え時	
＄スコープ切り換え時	
＄選択肢終了時	
＃────────▲▲ここまで里々の特殊変数▲▲────────	
＃────────▼▼ここからＬＮＰ独自変数▼▼────────	
＄KeyPressCommand_AcceptingInputs	0
＄Translate有効	1
＄ウェイト乗数	50
＄オート	0
＄オート_待ち時間	450
＄ゲームID	master
＄サーフェス_ウィンドウ	0
＄シェル名	master
＄スキップ	0
＄スキップ_未読で停止	1
＄スキップ_選択肢後維持	0
＄テキスピ乗数	100%
＄ハイド中	0
＄バックログ状態	0
＄マウス受付_ころころ	0
＄マウス受付_つつかれ	0
＄マウス受付_なでられ	0
＄マウス受付_クリック	0
＄メニュー中	0
＄ユーザ入力受付中	0
＄一体化中	0
＄中断再開中	0
＄外部プラグイン読み上げ対応	0
＄既読設定_文字色変更	1
＄既読設定_選択肢色変更	1
＄音量_BGM	50
＄音量_SE	50
＄音量_VOICE	50
＃────────▲▲ここまでＬＮＰ独自変数▲▲────────	
