＊セーブデータ
＄NOTIFYの自動保存	有効
＄SAORI引数の計算	自動
＄notification.shell_updated	0
＄s_master.オートセーブ	|チュートリアルＣ２|チュートリアルＢ|５|チュートリアル分岐:上|
＄s_master.グローバルセーブ	|タイトルバー:通常|
＄s_master.シェル情報.updated_before	0,0,0,0,0,0
＄s_master.シェル情報.updated_last	0,0,0,0,0,0
＄s_master.既読判定	|チュートリアルＡ３|チュートリアルＡ４|チュートリアルＡ５|チュートリアルＡ６|チュートリアルＡ７|チュートリアルＡ８|チュートリアルＡ９|チュートリアルＡ１０|チュートリアルＡ１１|チュートリアルＢ０|チュートリアルＢ１|チュートリアルＢ２|チュートリアルＢ３|チュートリアルＣ１|チュートリアルＡ０|チュートリアルＡ１|チュートリアルＡ２|チュートリアルＣ２|
＄なでられ時実行イベント	なでられ時の反応
＄ウェイト乗数	10
＄オート_待ち時間	50
＄ゲームID	master
＄ゴースト起動時間累計(ms)	2184000
＄ゴースト起動時間累計ミリ秒	2184000
＄ゴースト起動時間累計秒	2184
＄シェル名	master
＄スキップ_選択肢後維持	0
＄スキップ_未読で停止	1
＄テキスピ乗数	25%
＄トーク中のなでられ反応	有効
＄ハイド中	0
＄バルーン名	LilyNovelPlayer用バルーン
＄ユーザ名	ユーザ
＄一体化中	1
＄音量_BGM	25
＄音量_SE	25
＄音量_VOICE	25
＄会話時サーフェス戻し	無効
＄外部プラグイン読み上げ対応	0
＄既読設定_選択肢色変更	0
＄既読設定_文字色変更	0
＄起動回数	14
＄再生中VOICE	|
＄自動改行挿入	無効
＄自動挿入ウェイトの倍率	０％
＄自動挿入ウェイトタイプ	無効
＄辞書フォルダ	.,scenarios/master
＄喋り間隔	１０秒
＄喋り間隔誤差	０％
